1111111111111
1000000000001
1000000011001
10P0C00000001
10E0000000001
100EC00000001
1111111111111
